{
	"rowsCount": 31,
	"leftTunnelExit":[14, 0],
	"rightTunnelExit":[14, 27],
	"cells": [
		1, 1, 1, 1, 1, 1, 1, 1, 1, 1, 1, 1, 1, 1, 1, 1, 1, 1, 1, 1, 1, 1, 1, 1, 1, 1, 1, 1,
		1, 4, 4, 4, 4, 4, 4, 4, 4, 4, 4, 4, 4, 1, 1, 4, 4, 4, 4, 4, 4, 4, 4, 4, 4, 4, 4, 1,
		1, 4, 1, 1, 1, 1, 4, 1, 1, 1, 1, 1, 4, 1, 1, 4, 1, 1, 1, 1, 1, 4, 1, 1, 1, 1, 4, 1,
		1, 5, 1, 1, 1, 1, 4, 1, 1, 1, 1, 1, 4, 1, 1, 4, 1, 1, 1, 1, 1, 4, 1, 1, 1, 1, 5, 1,
		1, 4, 1, 1, 1, 1, 4, 1, 1, 1, 1, 1, 4, 1, 1, 4, 1, 1, 1, 1, 1, 4, 1, 1, 1, 1, 4, 1,
		1, 4, 4, 4, 4, 4, 4, 4, 4, 4, 4, 4, 4, 4, 4, 4, 4, 4, 4, 4, 4, 4, 4, 4, 4, 4, 4, 1,
		1, 4, 1, 1, 1, 1, 4, 1, 1, 4, 1, 1, 1, 1, 1, 1, 1, 1, 4, 1, 1, 4, 1, 1, 1, 1, 4, 1,
		1, 4, 1, 1, 1, 1, 4, 1, 1, 4, 1, 1, 1, 1, 1, 1, 1, 1, 4, 1, 1, 4, 1, 1, 1, 1, 4, 1,
		1, 4, 4, 4, 4, 4, 4, 1, 1, 4, 4, 4, 4, 1, 1, 4, 4, 4, 4, 1, 1, 4, 4, 4, 4, 4, 4, 1,
		1, 1, 1, 1, 1, 1, 4, 1, 1, 1, 1, 1, 0, 1, 1, 0, 1, 1, 1, 1, 1, 4, 1, 1, 1, 1, 1, 1,
		0, 0, 0, 0, 0, 1, 4, 1, 1, 1, 1, 1, 0, 1, 1, 0, 1, 1, 1, 1, 1, 4, 1, 0, 0, 0, 0, 0,
		0, 0, 0, 0, 0, 1, 4, 1, 1, 0, 0, 0, 0, 0, 0, 0, 0, 0, 0, 1, 1, 4, 1, 0, 0, 0, 0, 0,
		0, 0, 0, 0, 0, 1, 4, 1, 1, 0, 1, 1, 1, 2, 2, 1, 1, 1, 0, 1, 1, 4, 1, 0, 0, 0, 0, 0,
		1, 1, 1, 1, 1, 1, 4, 1, 1, 0, 1, 0, 0, 0, 0, 0, 0, 1, 0, 1, 1, 4, 1, 1, 1, 1, 1, 1,
		0, 0, 0, 0, 0, 0, 4, 0, 0, 0, 1, 0, 0, 0, 0, 0, 0, 1, 0, 0, 0, 4, 0, 0, 0, 0, 0, 0,
		1, 1, 1, 1, 1, 1, 4, 1, 1, 0, 1, 0, 0, 0, 0, 0, 0, 1, 0, 1, 1, 4, 1, 1, 1, 1, 1, 1,
		0, 0, 0, 0, 0, 1, 4, 1, 1, 0, 1, 1, 1, 1, 1, 1, 1, 1, 0, 1, 1, 4, 1, 0, 0, 0, 0, 0,
		0, 0, 0, 0, 0, 1, 4, 1, 1, 0, 0, 0, 0, 0, 0, 0, 0, 0, 0, 1, 1, 4, 1, 0, 0, 0, 0, 0,
		0, 0, 0, 0, 0, 1, 4, 1, 1, 0, 1, 1, 1, 1, 1, 1, 1, 1, 0, 1, 1, 4, 1, 0, 0, 0, 0, 0,
		1, 1, 1, 1, 1, 1, 4, 1, 1, 0, 1, 1, 1, 1, 1, 1, 1, 1, 0, 1, 1, 4, 1, 1, 1, 1, 1, 1,
		1, 4, 4, 4, 4, 4, 4, 4, 4, 4, 4, 4, 4, 1, 1, 4, 4, 4, 4, 4, 4, 4, 4, 4, 4, 4, 4, 1,
		1, 4, 1, 1, 1, 1, 4, 1, 1, 1, 1, 1, 4, 1, 1, 4, 1, 1, 1, 1, 1, 4, 1, 1, 1, 1, 4, 1,
		1, 4, 1, 1, 1, 1, 4, 1, 1, 1, 1, 1, 4, 1, 1, 4, 1, 1, 1, 1, 1, 4, 1, 1, 1, 1, 4, 1,
		1, 5, 4, 4, 1, 1, 4, 4, 4, 4, 4, 4, 4, 0, 0, 4, 4, 4, 4, 4, 4, 4, 1, 1, 4, 4, 5, 1,
		1, 1, 1, 4, 1, 1, 4, 1, 1, 4, 1, 1, 1, 1, 1, 1, 1, 1, 4, 1, 1, 4, 1, 1, 4, 1, 1, 1,
		1, 1, 1, 4, 1, 1, 4, 1, 1, 4, 1, 1, 1, 1, 1, 1, 1, 1, 4, 1, 1, 4, 1, 1, 4, 1, 1, 1,
		1, 4, 4, 4, 4, 4, 4, 1, 1, 4, 4, 4, 4, 1, 1, 4, 4, 4, 4, 1, 1, 4, 4, 4, 4, 4, 4, 1,
		1, 4, 1, 1, 1, 1, 1, 1, 1, 1, 1, 1, 4, 1, 1, 4, 1, 1, 1, 1, 1, 1, 1, 1, 1, 1, 4, 1,
		1, 4, 1, 1, 1, 1, 1, 1, 1, 1, 1, 1, 4, 1, 1, 4, 1, 1, 1, 1, 1, 1, 1, 1, 1, 1, 4, 1,
		1, 4, 4, 4, 4, 4, 4, 4, 4, 4, 4, 4, 4, 4, 4, 4, 4, 4, 4, 4, 4, 4, 4, 4, 4, 4, 4, 1,
		1, 1, 1, 1, 1, 1, 1, 1, 1, 1, 1, 1, 1, 1, 1, 1, 1, 1, 1, 1, 1, 1, 1, 1, 1, 1, 1, 1
	]
}

/* 0 - empty
 * 1 - wall
 * 2 - ghost house door
 * 3 - space
 * 4 - dot
 * 5 - big dot
 */